9
21
101111001110011011010
011001011110011111110
211101111101101010110
011110111001101111111
011111111101101001113
011111010101101011010
011111010111111111111
011110011011111101111
011111010101101011010